                                                                                                    
                                                                                                    
         .                                                                       .           .      
  .....  .  .........  ...........  ........................................      .  ....       .   
         .                                                                                          
         .                                                                                          
         .        .  .  .        .        .....                                      .  .           
     .   .       .                .                                                      .          
    .    .      .                      .           ................  .  .........         .    .    
   .     .     .              .       .         .                                  ..      .        
         .    .                      .         .                                       .    .       
         .                 .        .         .    .          .   .     .      .       .            
      .  .                  .                .    .           .    .    .              .            
         .  .....            .              .    .       .    .     .   .                      .    
                   .  .           .        .    .             .      .  .      .    .      .    .   
      .                .                  .    .              .         .          .   .            
       .                .      .         .    .               .             .          .            
  .     .     .          .    .         .    .                .                .       .            
   .     .     .          .            .    .          .      .          .      .      .            
    .     .     .          .          .    .            .     .           .      .     .            
     .     .     .    .     .        .    .    .    .    .    .   ...      .      .    .  .    .    
      .     .     .          .      .                         .        .    .      .   .       .    
       .     .     .     .    .    .                                   .            .  .       .    
        .     .                   .    .  .      .               .     .               .       .    
         .     .                 .        .  .    .    .    .          .      .        .       .    
          .             .       .         .        .        .          .     .      .  .    .  .    
           .         .         .          .         .       .  .    .  .    .          .       .    
            .    .            .    .      .          .      .   .          .                   .    
             .    .      .   .      .     .           .     .    .        .         .          .    
              .    .    .                              .                 .           .         .    
         .     .    .                                   .               .             .             
        .       .    .      .    ....................    .             .    ..  ...    .            
                 .    .      .                            .           .                 .       .   
                  .    .      .                            .    .    .                   .          
  .  .........     .      .    .  ....    .    ........     .    .           .                      
                    .                                             .           .                     
                .    .                                             .           .     .........      
     .    .      .    .    ..  .................................    .    ...    .                   
         .        .    .                                             .                              
  .     .          .    .                                             .                .            
  .           .     .    .        .  .        .        .          .    .     .         .  .         
  .          .       .    .      .    .      .   .      .          .    .     .            .        
  .  .      .         .    .    .      .          .         .       .    .     .                    
  .  .     .           .    .           .          .        .             .                   .     
  .  .             .    .    .     .                   .                            .    .          
  .     .                .    .     .                 .                              .              
  .                       .    .             ....    .    ..      ..     .            .     .  .    
                 .         .                        .         .           .   .        .       .    
                .                  .               .                       .   .        .      .    
       ...     .        .           .             .       .                     .        .     .    
              .        .     .       .           .    .          .     .         .        .    .    
    .        .        .               .         .     .           .    .     .    .        .   .    
   .        .        .          .      .              .            .   .      .             .  .    
           .        .       .           .             .                        .    .          .    
          .        .         .           .            .                         .      .       .    
  .                                                   .           .              .      .           
                                                   .  .  .......   .  ....               .  .       
     ............................................                                                .  
                                                                                                    
                                                                                                    