                                                                                          
                                                                                          
                                                                                          
      .                 .                               .                                 
     .                 .                     .           .                         .      
    .                                        .            .          .    .       .       
                                             .   .         .   .                 .        
          .                ...       .....   .                 .                .         
         .                                   .                 .               .          
                     .                       .                 .              .           
       .              .          .           .     .........   .   ....      .            
      .                .                                                    .             
           .            .                                                  .              
            .            .                                                .               
             .            .       ............................           .                
    .         .                                                         .                 
    .          .                                                       .                  
    .           .   .                                                 .                   
    .               .      .             .                 .         .                    
    .               .       .             .                 .       .                     
    .               .        .                                     .                      
    .               .            .                                .       .   .      .    
    .         .     .             .                              .             .          
    .         .     .              .         .                  .               .         
    .         .     .               .       .                  .                 .        
    .         .     .   .                  .                  .                           
              .                           .      .           .          .                 
              .                          .        .         .                             
          .   .            .            .          .       .          .                   
     .        .        .    .          .                  .          .                    
              .              .        .                  .          .     .       .       
              .               .      .       .          .          .       .       .      
          .   .                .              .        .          .         .             
              .     .           .              .      .          .           .            
                                 .                   .          .             .           
      .                           .                 .                          .          
                                   .               .       .                    .         
                        ......      .      .      .         .       .......      .        
                                     .           .           .                    .       
                                      .         .             .                    .      
    .......                                                    .                    .     
                                                                .                         
                                                                 .     .                  
                          ...............................         .    .                  
            .                                                          .                  
             .     .                                                   .       .          
                    .                                                  .        .         
    .                          .        .         .                    .         .        
     .                         .       .           .                   .                  
      .       .                .      .             .         .                           
       .      .                .     .               .       .                            
        .     .                .    .                       .                             
              .        .       .   .                       .       .          .           
              .         .      .                          .         .          .          
                   .           .                 ..      .           .          .         
                               .       .                .                 .               
                                                                                          
                                                                                          
                                                                                          
                                                                                          